NO ./texture/door1.png

SO ./texture/door2.png

EA ./texture/clock.png

WE ./texture/wall.png

F 169,169,169

C 250,235,215

111111111111111111111111
100000000001110000000001
111011111101110101111111
100010000011010100000001
101110111101010101110101
100000100001000100000001
101111101111011111101111
100000100000010000100001
101111111011011011111101
100000001010101000000001
101111111010101011111101
100000000N00000000000001
111111111111111111111111
